1111111111
1E00000001
1000CC0001
1000CC0001
1000CC0001
1000CC0001
1000CC0001
1000CC0001
10000000P1
1111111111
